1111111111111
1000000000001
1000111110011
1P0011EE0C0E1
1111111111111